{
  "width": 20,
  "height": 20,
  "data":[
    2,2,2,2,2,2,2,2,2,2,2,1,1,1,1,1,1,1,1,2,
    2,2,2,2,2,2,2,2,2,2,2,1,1,1,1,1,1,2,1,2,
    2,2,2,2,2,2,2,2,2,2,2,1,1,1,1,1,1,1,1,2,
    2,2,2,2,2,2,2,2,2,2,2,1,1,1,1,1,1,1,1,2,
    2,2,2,2,2,2,2,2,2,2,2,1,2,1,1,2,1,1,1,1,
    2,1,1,1,1,1,1,1,1,1,2,2,2,1,1,1,1,2,1,1,
    1,1,1,1,2,1,2,2,2,1,2,2,2,1,1,1,1,1,1,1,
    1,1,1,2,1,1,2,2,2,1,5,1,2,1,1,1,1,1,1,6,
    1,1,1,1,1,1,2,2,2,1,1,1,1,1,1,2,2,2,2,2,
    1,1,2,2,2,2,2,2,2,2,2,1,1,1,1,2,2,2,2,2,
    1,1,2,2,2,2,2,2,2,2,2,1,1,1,1,2,2,2,2,2,
    1,1,2,2,2,2,2,2,2,2,2,1,1,1,1,2,2,2,2,2,
    2,2,2,2,2,2,2,3,2,2,2,2,1,1,1,2,2,2,2,2,
    2,2,2,2,1,2,2,1,1,2,1,1,1,1,1,2,2,2,2,2,
    2,2,2,2,1,1,1,1,1,1,1,1,1,1,1,2,2,2,2,2,
    2,2,2,2,2,2,2,2,2,2,2,1,1,1,1,1,1,1,1,1,
    2,2,2,2,2,2,2,2,2,2,2,2,2,1,1,1,1,2,2,2,
    2,2,2,2,2,2,2,2,2,2,2,2,2,1,1,1,2,2,2,2,
    2,2,2,2,2,2,2,2,2,2,2,2,2,1,1,1,1,2,2,2,
    2,2,2,2,2,2,2,2,2,2,2,2,2,4,4,1,1,1,2,2
  ],
  "content": {
    "1":"walkable",
    "2":"unwalkable",
    "3":"Shop",
    "4":"Battle",
    "5":"Treasure",
    "6":"Next"
  }
}
