{
"width": 19,
"height": 19,
"data": [
  20,20,20,20,10,20,10,20,10,10,10,20,10,20,10,20,20,20,20,
  20,20,20,20,10,20,10,20,10,10,10,20,10,20,10,20,20,20,20,
  20,20,20,10,10,10,10,10,10,10,10,10,10,10,10,10,20,20,20,
  20,20,20,10,10,20,10,10,10,10,10,10,10,20,10,10,20,20,20,
  20,20,20,10,10,10,10,10,10,11,10,10,10,10,10,10,20,20,20,
  20,20,20,10,10,20,10,10,10,10,10,10,10,20,10,10,20,20,20,
  20,20,20,10,10,10,10,20,10,10,10,20,10,10,10,10,20,20,20,
  20,20,20,10,10,10,10,10,10,10,10,10,20,10,10,10,20,20,20,
  20,20,20,20,20,20,20,20,10,10,10,20,20,20,20,20,20,20,20,
  20,20,20,20,20,20,20,20,10,10,10,20,20,20,20,20,20,20,20,
  20,20,20,10,10,10,10,20,10,10,10,10,10,10,10,20,20,20,20,
  20,20,20,10,20,10,10,10,10,10,10,10,10,10,10,10,20,20,20,
  20,20,20,20,10,10,10,10,10,10,10,20,10,10,10,10,20,20,20,
  20,20,20,10,10,10,10,20,10,10,10,20,10,10,20,10,20,20,20,
  20,20,20,20,20,20,10,10,10,10,10,10,10,20,20,20,20,20,20,
  20,20,20,20,20,20,10,10,10,10,10,10,10,20,20,20,20,20,20,
  20,20,20,20,20,20,10,20,10,10,10,20,10,20,20,20,20,20,20,
  20,20,20,20,20,20,20,20,10,10,10,20,20,20,20,20,20,20,20,
  20,20,20,20,20,20,20,20,11,11,11,20,20,20,20,20,20,20,20],
"content": {
    "10": "walkable",
    "11": "wevent",
    "20": "unwalkable",
    "21": "uevent"
  },
  "born": [9.5, 14.5]
}

